110000000000000000000000000000000000000000000000000000000000000000000000000000000000000000000000000000000000000000000000000000000000000000000000000000000000000000000000000000000000000000000000000000000000000000000000000000000000000000000000000000000000000000000000000000000000000000000000000000000000000000000000000000000000000000000000000000000000000000000000000000000000000000000000000000000000000000000000
110000000000000000000000000000000000000000000000000000000000000000000000000000000000000000000000000000000000000000000000000000000000000000000000000000000000000000000000000000000000000000000000000000000000000000000000000000000000000000000000000000000000000000000000000000000000000000000000000000000000000000000000000000000000000000000000000000000000000000000000000000000000000000000000000000000000000000000000
110000000000000000000000000000000000000000000000000000000000000000000000000000000000000000000000000000000000000000000000000000000000000000000000000000000000000000000000000000000000000000000000000000000000000000000000000000000000000000000000000000000000000000002019201920000000000000000000000000000000000000000000000000000000000000000000000000000000000000000000000000000000000000000000000000000000000000000000
110000000000000000000000000000000000000000000000000000000000000000000000000000000000000000000000000000000000000000000000000000000000000000000000000000000000000000000000000000000000000000000000000000000000000000000000000000000000000000000000200000030000002100000000000500000000000000000000000000000000000000000000000000000000000000000000000000000000000000000000000000000000000000000000000000000000000000000000
110000000000000000000000000000000000000000000000000000000000000000000000000000000000000000000000000000000000000000000000000000000000000000000000000000000000000000000000000000000000000000000000000000000000000000000000000000000000000000002000000018121700000000181212121212170000000000000000000000000000000000000000000000000000000000000000000000001919000000000000000000000000000000000000000000000000000000000000
110000000019000000000000000000000000000000000000000000000000000000000000000000000000000000000000000021210021210021210000000000000000000000000000000000210020202020000000000000000021210021210021210000000000000019190019190019190000000000000000140000000000001400002020202020020000000000000000000000000000000000000000000000000000000000000000000000000000000000202000202000000000000000000000000000000000000000000000
110000190000000000000000000000000000000000000000000000000000000000000000000000000000000000000000000000000000000000000003000000000000000000000000002100000018121217000006060607060000000000000000000006060606060200000000000000000006060600001400000000000014000000001612121212121212150003000000002121212121210000000000000000000000000000000000000000130101130200000002000000040000000000002000000000000000200000000000
111900000014000000000000000000000000000000000000000000002020002020000000000000000000000000000216121500001400001400001612150000000000000000000021000000140000000000001612121212121500001400001400001612121212121500001400001400001812121217000000000000140000020000161111111111111111111212121500020607060606060000000000000000190000000000000002001301111212111215000014000018121212121217000000000000000000000000000000
110000140000000000000000000000000000000000000000000002000000000000000002000000000000000016121211111100000000000000001111111502000000000000000000001400000000000000001111111111111100000000000000001111111111111100000000000000000000000000000000001400000000161212111111111111111111111111111112121212121212121212170000000000190000000000000013011112111111111111000000000000000000000000001400000000030000140000000200
111500000000000000000000000000000000000000000003001612150101130101161215000004000003001611111111111100000000000000001111111112150003202020200014000000000000000000001111111111111100000000000000001111111111111100000000000000000002000000000013000004001612111111111111111111111111111111111111111111111111111119190016150000190000000000130111121111111111111111000000000000000000000000000000161212121700000018121212
111115000000000000020000000000080000000000161212121111111212111212111111121212121212121111111111111100000000000000001111111111111212121212150000000000000000000000001111111111111100000000000000001111111111111101011301011301011612121212121211121212121111111111111111111111111111111111111111111111111111111112121211111500030000021301111211111111111111111111000000000000000000000000000000111111111919131919111111
111111121212121212121212121212121212121212111111111111111111111111111111111111111111111111111111111100000000000000001111111111111111111111110000000000000000000000001111111111111100000000000000001111111111111112121112121112121111111111111111111111111111111111111111111111111111111111111111111111111111111111111111111112121212121112111111111111111111111111000000000000000000000000000000111111111212111212111111